NO ./srcs/main.c
SO ./srcs/main.c
WE ./srcs/main.c
EA ./srcs/main.c

F 220,100,0
C 225,30,0

11111111
10100001
10100001
10100001
10000001
10001001
100N0001
11111111