NO ./srcs/main.c
SO ./srcs/main.c
WE ./srcs/main.c
EA ./srcs/main.c

C 0,255,255
F 224,224,224

11111111
10100001
10100001
10100001
10000001
10001001
100N0001
11111111
