NO ./test.xpm
SO ./test2.xpm
WE ./test3.xpm
EA ./test4.xpm

C 0,255,255
F 224,224,224

11111111
10000001
10000001
10000001
10000001
10000001
10N00011
11111111
