NO ./test.xpm
SO ./test2.xpm
WE ./test3.xpm
EA ./test4.xpm

C 0,255,255
F 224,224,224

        1111111111111111111111111
        1000000000110000000000001
        1011000001110000000000001
        1001000000000000000000001
111111111011000001110000000000001
100000000001100000111011111111111
11110111111111011100000010001
11110111111111011101010010001
11000000110101011100000010001
10000000000000001100000000001
10000000000000001101010010001
1100000111010101111101111000111
11110111 1110101 101111010W01
11111111 1111111 111111111111
