NO ./test.xpm
EA ./test4.xpm
SO ./test2.xpm
WE ./test3.xpm

C 255,255,255
F 255,255,255

        1111111111111111111111111
        1000000000110000000010001
        1011000001110000000010001
        1001000000000000000010W01
111111111011000001110000000010001
100000000001100000111011111111111
11110111111111011100000010001
11110111111111011101010010001
11001000110101011100000010001
100101000000000001100001110001
100010000000000001101001010001
110000011101010111110001110011
11110111 1110101 100000000011
11111111 1111111 111111111111
