
    
   NO ./srcs/main.c  
SO ./srcs/main.c    
WE ./srcs/main.c    
 EA ./srcs/main.c          

F 220,0,25
 C 225,30,0 
              
 11111111111111111111111111
1100000000110000000000001
1011000001110000000000001
1001000000000000 0000000111111111
111111111111000001110000000000001
100000000011000001110111111111111
11110111111111011100 00010001
1111011 111111011101010010001
11000111110101011100000010001
1000000000000000110000000001
10000000000000001101010010001
11000001110101011111011110N0111
11111111 1111111 11111111111111