NO ./test.xpm
SO ./srcs/main.c
WE ./srcs/main.c
EA ./srcs/main.c

C 0,255,255
F 224,224,224

11111111
10100001
10101001
10100011
10101001
10001001
101N0011
11111111
