NO ./srcs/main.c
SO ./srcs/main.c
WE ./srcs/main.c
EA ./srcs/main.c

F 220,100,0
C 225,30,0

111111111
100000001
100000001
100000001
100000001
100000001
100000001
10000N001
111111111